# game/levels/level2.txt - LABERINTO TECNOLÓGICO
# Nivel 2: Laberinto vertical con múltiples rutas
# Tamaño: 32x18 tiles (960x540px - coincide con tu resolución)

111111111111111111111111111111
100000000000000000000000000001
101100000000000000000000000001
100000000000000000000000000001
10000111100000000000000M000001
100000000000000000001111100001
100000000000000011110000000001
100000000001100000000000110001
100110000001100000000000000001
100000000000000001110000000001
100111011000000000000000000001
100000000000000000000001100001
100000000000000000001000000001
100001110000000111100000000001
100000000000000000000000000001
100000000111100000000011100001
100000000001100000000000000001
100000011100000111100000000001
111111111111111111111111111111
