1000000000000000000000000000000000000000000000000000000000000001
1000000000000000000000000000000000000000000000000000000000000001
1000000000000000000000000000000000000000000000000000000000000001
1000000000000000000000000000000000000000000000000000000000000001
1000010000000000000010000000000000000100000000000000100000000001
1000111000000000000011000000000000001110000000000001110000000001
1001111100000000000111100000000000011111000000000011111000000001
1011111110000000001111110000000000111111100000000111111100000001
1011111111000000011111111000000000111111110000000111111110000001
1111111111100000111111111100000001111111111000001111111111000M01
1111111111111111111111111111111111111111111111111111111111111111
