



11111111111111111111111111111111
10000000000000100000000000000001
10111111111110101111111111111001
10100000000100100000000000101001
10101111110111101111111010101001
10101000010000001000001010101001
10101011111111111111101010101001
10101000000000000100001010101001
10101111111111110111111010101111
10100000000000000100000010100001
10111111111111111111111010111001
1000000000000000M000001010001001
11111111111000111111101010101001
10000000000000000000101010101001
10111111111111111110101010101001
10100000000000000000100010101001
10101111111111111100011110101001
10100000000000000000000100001001
10111111111100001111110011101001
10000000000000000000000000000001
11111111111111111111111111111111

