



111111111111111111111111111111111
1M0000000000000000000000000000001
111101111110101111111111111110101
100001000000100000000000000010001
101111011111111111101111111011101
101000010000000001001000000010001
101011110111111101111011111011101
100010000100000100000010000010001
101110111101111111111110111111101
100000100001000000000000100000001
101111111101011111111101111111101
101000000001010000000101000000101
101011111101011111110101111110101
100010000001000000010000000010001
111110111111111111111111111111101
100000100000000000000000000000001
101111111111111111111111111111101
1000000000000000000000000000000M1
111111111111111111111111111111111
